50:15
11111111111111111111111111111111111111111111111111
11000000000000000111111111111110000000000000000001
10011000000000000001111111100000000000000000000001
10000000000010000000111111100000000111110000000001
01000000010010000000011111111111000000001100000001
11112221111100110000001011111111110000000111000001
11111111110001100000000110001111110000000001110001
11111000000000001111000000000111001100000000000001
11000000000010000000000111000000000000000000000001
10000000000011100000000000000000000001100111100001
10000011100000000000011100111100000000000000000111
11110000000000000110000000000001100100000000001111
11110000000000000111000000000000001100011000001111
11111122111222111111222222222222221111111111111111
11111111111111111111111111111111111111111111111111
Coin(3,1)(4,1)(36,2)(38,2)(1,3)(9,3)(27,3)(28,3)(29,3)(30,3)(31,3)(40,3)(2,4)(3,4)(7,4)(42,4)(20,5)(23,5)(44,5)(16,6)(18,6)(10,7)(27,9)(8,12)(36,12)(37,12)(41,12)(43,12)(45,12)
Enemy(39,2)(8,4)(43,4)(41,8)(43,8)(22,9)(28,9)(32,10)(36,11)(38,11)(40,11)(42,11)(43,11)(4,12)(15,12)
Exit(48,9)
Player(1,10)
