50:15
11111111111111111111111111111111111111111111111111
11111000011111111111111111111111111110000000111111
11100000001111110011110111100011111100000000000111
11000111000000011001100110000001111001100000000011
10000000000000001000100011000000110000010000000001
10000000001100000000000001110000110000000000000001
11001210001110000000000000111000000000000111110111
11111111111111000000000000000000000000111100011111
10000000000000000000111100011111000001000000000111
10000000000000011100000000110001100110000000000001
10000000000000000000000000100000100000011111100001
10001110000111000000000100000000010000000000000001
10011111100001000011000100000000010000000000000001
11111111100001111111111111122211111112211112211111
11111111111111111111111111111111111111111111111111
Coin(5,2)(7,2)(37,2)(26,4)(1,5)(5,5)(2,6)(8,6)(39,6)(22,7)(16,8)(39,9)(41,9)(43,9)(47,11)(17,12)(21,12)(31,12)(32,12)(39,12)(42,12)(46,12)(48,12)(12,13)
Enemy(12,3)(25,3)(4,5)(6,5)(43,5)(21,7)(37,7)(31,11)(16,12)(35,12)(47,12)(10,13)
Exit(48,5)
Player(1,12)
