50:20
11111111111111111111111111111111111111111111111111
11111110111000111111111110000111111111111111111111
11100000010000000011111100000000100001111000000111
10000000010000000001111000000000000000100000000011
10000000000110000000110000001110000000000000000011
11111000000000000000000000111000000000001001000001
10011000000000000000000001100000001111011000111001
10001111221112211001111000000000111111011100000001
10000001111111100001001100000000000000011100000001
11110000000001000011000110000000000000011110000001
10000000000000001110000001100000000000001111110001
10000000000000001100000000110000000000000111111111
10111222111221110000000110010000000000000111111111
10111111111111110000010000000011111100000011100001
10000000000000000000110000000000000000000011000001
10000000000000000001100000000000000001110010000001
11100011100111000111000011000000000000000000000111
11110000000000000110000111000000000000000000011111
11112222222222222110000111111221112211122211111111
11111111111111111111111111111111111111111111111111
Coin(11,3)(30,3)(27,4)(46,5)(11,6)(15,6)(33,6)(1,8)(42,8)(43,9)(44,9)(47,10)(48,10)(4,11)(10,11)(23,11)(34,12)(20,13)(19,14)(7,15)(8,15)(12,15)(13,15)(17,15)(18,15)(26,17)(31,17)(37,17)(41,17)(19,18)(21,18)
Enemy(34,5)(45,5)(6,6)(25,7)(2,8)(16,8)(43,8)(45,9)(46,10)(3,11)(9,11)(32,12)(6,15)(11,15)(32,17)(43,17)(20,18)(22,18)
Exit(48,15)
Player(1,4)
