23:23
00000000000000000000000
22222200000000000000000
22222022200000000000000
00000222222000000000000
00000000002222200002000
00000000000020022222000
00000002200022022000000
00000002220002200000000
00222222000022000000000
00002222222220000000000
02000222022200000000000
02000000222200000000000
02200002222200000000000
00022022222222000000000
00002220220222222200000
00000022222222220022220
00000000002222222220022
00000000000000000002220
00000000000000000000000
00000000000000000000000
00000000000000000000000
00000000000000000000000
00000000000000000000000
