30:31
000000000000000000000000000000
000000000000000000000000000000
000000000000000000000000000000
000000000000000000000000000000
000000000001111110000000000000
000000000001000001110000000000
000000000010000000001100000000
000000000011000000000110000000
000000000001100000000010000000
000000001111111110000010000000
000000011000011001111110000000
000000110001111111110100000000
000000100111000110000000000000
000000111000000010000000000000
000000011000000010000000000000
000000001111000110000000000000
000000001100111110000000000000
000000000111111001111100000000
000000000000000000000111000000
000000000000000000000001100000
000000000000000000000000100000
000000000000000111111111100000
000000000000000000000000000000
000000000000000000000000000000
000000000000000000000000000000
000000000000000000000000000000
000000000000111111110000000000
100000000000000000010000000001
101111000011222222211000000001
111111111111111111111112212111
111111111111111111111111111111
Coin(9,28)(12,25)
Enemy(24,27)
Exit(16,25)
Player(15,25)
