15:15
000000000000000
000000000000000
000000000000000
000000000000000
000000000000000
000000000000000
000000000000000
000000000000000
000000000000110
000000000011100
000000011100000
000000010000000
000110000000000
000000000000000
111111222211111
Coin(13,7)(4,8)(8,8)(10,8)(11,8)
Enemy(3,11)(5,11)(11,12)(9,13)(12,13)
Exit(12,7)
Player(1,13)
